{
  "id": "arena",
  "name": "Arena",
  "description": "An open fighting pit with\nsymmetric stone pillars.",
  "rows": [
    "################",
    "#..............#",
    "#.##........##.#",
    "#..............#",
    "#...##....##...#",
    "#..............#",
    "#..............#",
    "#...##....##...#",
    "#..............#",
    "#.##........##.#",
    "#..............#",
    "################"
  ]
}
