{
  "id": "catacombs",
  "name": "Catacombs",
  "description": "Winding corridors through\nancient stone passages.",
  "rows": [
    "################",
    "#..............#",
    "##############.#",
    "#..............#",
    "#.##############",
    "#..............#",
    "##############.#",
    "#..............#",
    "#.##############",
    "#..............#",
    "#..............#",
    "################"
  ]
}
