{
  "id": "dungeon",
  "name": "Dungeon",
  "mapdescription": "Five chambers of uneven size: an antechamber near the southern entrance, a cramped guard post and a sealed inner sanctum to the north-west, a large central hall, and a storage alcove to the north-east. The entrance is a 3-tile gap in the centre of the southern wall; players typically start in the antechamber just inside it.",
  "rows": [
    "##############################",
    "##############################",
    "###.........##################",
    "###.........#######........###",
    "###.........#######........###",
    "###.........#######........###",
    "###.........#######........###",
    "###.........#######........###",
    "###########.########..########",
    "###########............#######",
    "###########............#######",
    "##......###............#######",
    "##.....................#######",
    "##......###............#######",
    "##......###............#######",
    "####..#####............#######",
    "##........#............#######",
    "##........####################",
    "##........####################",
    "##........####################",
    "##........####################",
    "####...#######################"
  ]
}
