{
  "id": "dungeon",
  "name": "Dungeon",
  "description": "Two chambers divided by\na wall, linked by a gap.",
  "rows": [
    "####################",
    "#.......####.......#",
    "#.......####.......#",
    "#.......####.......#",
    "#..................#",
    "#.......####.......#",
    "#.......####.......#",
    "#.......####.......#",
    "#.......####.......#",
    "#.......####.......#",
    "#.......####.......#",
    "####################"
  ]
}
