{
  "id": "forest_trail",
  "name": "Forest Trail",
  "description": "A narrow trail through dense woodland.\nBandits lurk in the trees.",
  "rows": [
    "######################",
    "######################",
    "##....################",
    "##......######.......#",
    "#........####........#",
    "#........####........#",
    "......................",
    "......................",
    "#........####........#",
    "#........####........#",
    "##......######.......#",
    "##....################",
    "######################",
    "######################"
  ]
}
