{
  "id": "ruins",
  "name": "Ruins",
  "description": "Scattered rubble across\nan open battlefield.",
  "rows": [
    "####################",
    "#..................#",
    "#.##...........##..#",
    "#..................#",
    "#....##.....##.....#",
    "#..................#",
    "#..................#",
    "#.....##.....##....#",
    "#..................#",
    "#..##...........##.#",
    "#..................#",
    "#..................#",
    "#.##...........##..#",
    "####################"
  ]
}
