{
  "id": "ruins",
  "name": "Ruins",
  "mapdescription": "Crumbling remains of a fortified complex set in open ground: a partially intact northern sanctum, two collapsed watchtowers flanking a ruined central hall, and a rubble-strewn open approach to the south. The map is open at all edges; players typically start at the southern edge.",
  "rows": [
    "..............................",
    "..............................",
    "....############..............",
    "....#..........#..............",
    "....#..........#..............",
    "....#..........#..............",
    "....#..........#..............",
    "....####..######..............",
    "...........#########..........",
    "..#######..#.......#.#######..",
    "..#.....#..#.......#.#.....#..",
    "..#........#.......#.......#..",
    "..#.....#..#.......#.#.....#..",
    "..###..##..#.......#.###..##..",
    "...........###..####..........",
    "......#...............#.......",
    "..............................",
    ".............#.........#......",
    "..............................",
    "....#...........#.............",
    "..............................",
    ".............................."
  ]
}
