{
  "id": "tavern",
  "name": "The Rusty Flagon",
  "mapdescription": "A smoky common room with a long bar counter along the north wall, service hatches at each end for the keeper, and three staggered rows of patron tables. The entrance is a 4-tile gap in the centre of the southern wall; players typically start just inside the door.",
  "rows": [
    "##########################",
    "#........................#",
    "#.######################.#",
    "#........................#",
    "#..##.........##.....##..#",
    "#..##.........##.....##..#",
    "#........................#",
    "#........................#",
    "#........................#",
    "#.......##.......##......#",
    "#.......##.......##......#",
    "#........................#",
    "#........................#",
    "#..##......##.......##...#",
    "#..##......##.......##...#",
    "#........................#",
    "#........................#",
    "#........................#",
    "#........................#",
    "###########....###########"
  ]
}
