{
  "id": "tavern",
  "name": "The Rusty Flagon",
  "description": "A warm, smoky tavern. Patrons nurse their drinks, and the keeper eyes every newcomer from behind the bar.",
  "rows": [
    "####################",
    "#..................#",
    "#..................#",
    "#.################.#",
    "#..................#",
    "#...##.......##....#",
    "#..................#",
    "#...##.......##....#",
    "#..................#",
    "#...##.......##....#",
    "#..................#",
    "#...##.......##....#",
    "#..................#",
    "#..................#",
    "########....########"
  ]
}
